                            C                                   133                     ,423432,            32 
            WE                                   hdfsoifgsdfd
            WE                                      

11111111
100   N1                                         
11111111
10000001














       