F     1,                           255,                                      32                     
C     12,42,32
WE                                  sh              
NO                                   fsd
SO                                   fdssadsfds
EA                                   hdfsoifgsdfd







11111111
100  N 1                                     
11111111

00










       