F       76                    ,              76         ,             76

        NO              textures/simonkraft/cobblestone.png
                    SO                  textures/simonkraft/cobblestone_01.png
                            WE  textures/simonkraft/mossy_cobblestone1.png
EA                                          textures/simonkraft/cobblestone_02.png

C           99 ,                                                   99 ,      99

        1111111111111111111
11111111111110W1001001001000001
1011000001000001001
1001001001111101111
10011110000010010011111111111111111111111111
10000000000000010           01
10011111111110010011111111111111111111
1111000000000001011
1000000001000000001
1111111111111111111

